Sentence	MOR_Tier
it is a field .	pron|it-Prs-Nom-S3 aux|be-Fin-Ind-Pres-S3 det|a-Ind-Art noun|field .
keep it (.) &-er there .	verb|keep-Fin-Imp-S pron|it-Prs-Acc-S3 adv|there .
I'm getting them up .	pron|I-Prs-Nom-S1~aux|be-Fin-Ind-Pres-S1 verb|get-Part-Pres-S pron|they-Prs-Acc-P3 adp|up .
keeping it round [?] here .	verb|keep-Part-Pres-S pron|it-Prs-Acc-S3 adv|round adv|here .
they won't fit in there !	pron|they-Prs-Nom-P3 aux|will-Fin-S~part|not verb|fit-Inf-S adp|in adv|there !
yeah make it right bigger right there .	intj|yeah verb|make-Fin-Imp-S pron|it-Prs-Acc-S3 adv|right adj|big-Cmp-S1 adv|right adv|there .
got [?] these [?] down there !	verb|get-Fin-Ind-Past-S1-irr pron|this-Dem-P1 adp|down adv|there !
xxx xxx won't fit in the the curve [?] .	aux|will-Fin-S~part|not verb|fit-Fin-Imp-S adp|in det|the-Def-Art det|the-Def-Art noun|curve .
need a little one now .	verb|need-Fin-Ind-Pres-S det|a-Ind-Art adj|little-S1 noun|one-Acc adv|now .
I'll get a little one .	pron|I-Prs-Nom-S1~aux|will-Fin-S verb|get-Inf-S det|a-Ind-Art adj|little-S1 noun|one-Acc .
have we got a little one ?	aux|have-Fin-Ind-Pres-P1 pron|we-Prs-Nom-P1 verb|get-Part-Past-S-irr det|a-Ind-Art adj|little-S1 noun|one-Acc ?
I'll find a little one .	pron|I-Prs-Nom-S1~aux|will-Fin-S verb|find-Inf-S det|a-Ind-Art adj|little-S1 noun|one-Acc .
you've got a little one .	pron|you-Prs-Nom-S2~aux|have-Fin-Ind-Pres-S2 verb|get-Part-Past-S-irr det|a-Ind-Art adj|little-S1 noun|one-Acc .
that's a gap .	pron|that-Dem~aux|be-Fin-Ind-Pres-S3 det|a-Ind-Art noun|gap .
no this can (.) a horsie can jump over [?] the wall .	intj|no pron|this-Dem-S1 aux|can-Fin-S det|a-Ind-Art noun|horsie aux|can-Fin-S verb|jump-Inf-S adp|over det|the-Def-Art noun|wall .
it can round [?] there .	pron|it-Prs-Nom-S3 aux|can-Fin-S adv|round adv|there .
and I've got two tigers .	cconj|and pron|I-Prs-Nom-S1~aux|have-Fin-Ind-Pres-S1 verb|get-Part-Past-S-irr num|two noun|tiger-Plur-Acc .
that's a +...	pron|that-Dem~aux|be-Fin-Ind-Pres-S3 det|a-Ind-Art +...
and that's a tiger .	cconj|and pron|that-Dem~aux|be-Fin-Ind-Pres-S3 det|a-Ind-Art noun|tiger .
hey I've got lots tigers !	intj|hey pron|I-Prs-Nom-S1~aux|have-Fin-Ind-Pres-S1 verb|get-Part-Past-S-irr noun|lot-Plur noun|tiger-Plur-Acc !
where's the lion ?	adv|where~aux|be-Fin-Ind-Pres-S3 det|the-Def-Art noun|lion ?
that's that's a dog [?] .	pron|that-Dem~aux|be-Fin-Ind-Pres-S3 pron|that-Dem~aux|be-Fin-Ind-Pres-S3 det|a-Ind-Art noun|dog .
that's +...	pron|that-Dem~aux|be-Fin-Ind-Pres-S3 +...
some of them are old .	det|some-Def-Ind adp|of pron|they-Prs-Acc-P3 aux|be-Fin-Ind-Pres-P3 adj|old-S1 .
we've got a lot of tigers .	pron|we-Prs-Nom-P1~aux|have-Fin-Ind-Pres-P1 verb|get-Part-Past-S-irr det|a-Ind-Art noun|lot-Acc adp|of noun|tiger-Plur .
these are tigers xxx xxx .	pron|this-Dem-P1 aux|be-Fin-Ind-Pres-P3 noun|tiger-Plur .
but you said [?] that that's a tiger .	cconj|but pron|you-Prs-Nom-S2 verb|say-Fin-Ind-Past-S2-irr sconj|that pron|that-Dem~aux|be-Fin-Ind-Pres-S3 det|a-Ind-Art noun|tiger .
that's the fur .	pron|that-Dem~aux|be-Fin-Ind-Pres-S3 det|the-Def-Art noun|fur .
them go on there .	pron|they-Prs-Acc-P3 verb|go-Fin-S adp|on adv|there .
there's a tree there .	pron|there-Int-S1~verb|be-Fin-Ind-Pres-S3 det|a-Ind-Art noun|tree adv|there .
that's a big tree .	pron|that-Dem~aux|be-Fin-Ind-Pres-S3 det|a-Ind-Art adj|big-S1 noun|tree .
there might be another somewhere .	pron|there-Int-S1 aux|might-Fin-S verb|be-Inf-S det|another-Def-Ind adv|somewhere .
needta make (.) I want a big field right right there .	noun|needta verb|make-Fin-Imp-S pron|I-Prs-Nom-S1 verb|want-Fin-Ind-Pres-S1 det|a-Ind-Art adj|big-S1 noun|field-Acc adv|right adv|right adv|there .
that's a door cap [?] .	pron|that-Dem~aux|be-Fin-Ind-Pres-S3 det|a-Ind-Art noun|door noun|cap .
and kangaroos go round there .	cconj|and noun|kangaroo-Plur verb|go-Fin-Ind-Pres-P3 adv|round adv|there .
kangaroo's done that .	propn|kangaroo~aux|be-Fin-Ind-Pres-S3 verb|do-Part-Past-S-irr pron|that-Dem .
a bit more room with [?] these kangaroos got here [?] .	det|a-Ind-Art noun|bit adj|more-Cmp-S1 noun|room adp|with det|this-Def-Dem-Plur noun|kangaroo-Plur verb|get-Fin-Ind-Past-P3-irr adv|here .
and [?] ah that's a baby one !	cconj|and intj|ah pron|that-Dem~aux|be-Fin-Ind-Pres-S3 det|a-Ind-Art noun|baby noun|one !
a baby is it ?	det|a-Ind-Art noun|baby aux|be-Fin-Ind-Pres-S3 pron|it-Prs-Nom-S3 ?
oh (.) what them all get mixed up .	intj|oh pron|what-Int-S1 pron|they-Prs-Acc-P3 det|all-Def-Tot aux|get-Fin-Ind-Pres-P3 verb|mix-Part-Past-S adp|up .
they're new ones .	pron|they-Prs-Nom-P3~aux|be-Fin-Ind-Pres-P3 adj|new-S1 noun|one-Plur .
what , don't put them next to the other ones .	pron|what-Int-S1 cm|cm aux|do-Fin-Imp-S~part|not verb|put-Fin-Imp-S pron|they-Prs-Acc-P3 adv|next adp|to det|the-Def-Art adj|other-S1 noun|one-Plur .
and where's the old ones ?	cconj|and adv|where~aux|be-Fin-Ind-Pres-S3 det|the-Def-Art adj|old-S1 noun|one-Plur ?
is these some bricks ?	aux|be-Fin-Ind-Pres-S3 pron|this-Dem-P1 det|some-Def-Ind noun|brick-Plur ?
that's a cat .	pron|that-Dem~aux|be-Fin-Ind-Pres-S3 det|a-Ind-Art noun|cat .
got a cat there and monkeys run up the field .	verb|get-Fin-Ind-Past-S1-irr det|a-Ind-Art noun|cat-Acc adv|there cconj|and noun|monkey-Plur verb|run-Fin-Ind-Pres-P3 adp|up det|the-Def-Art noun|field .
din din is it ready ?	noun|din noun|din aux|be-Fin-Ind-Pres-S3 pron|it-Prs-Nom-S3 adj|ready-S1 ?
I can do this one , all [?] this .	pron|I-Prs-Nom-S1 aux|can-Fin-S verb|do-Inf-S det|this-Def-Dem-Sing num|one cm|cm det|all-Def-Tot pron|this-Dem-S1 .
where's bit [?] ?	adv|where~aux|be-Fin-Ind-Pres-S3 noun|bit ?
where's the next [?] bit ?	adv|where~aux|be-Fin-Ind-Pres-S3 det|the-Def-Art adj|next-S1 noun|bit ?
xxx xxx xxx can't find it .	aux|can-Fin-S~part|not verb|find-Inf-S pron|it-Prs-Acc-S3 .
then you can find that bit .	adv|then pron|you-Prs-Nom-S2 aux|can-Fin-S verb|find-Inf-S det|that-Def-Dem-Sing noun|bit-Acc .
do these first then you can find that bit .	verb|do-Fin-Imp-S pron|this-Dem-P1 adj|first-S1 adv|then pron|you-Prs-Nom-S2 aux|can-Fin-S verb|find-Inf-S det|that-Def-Dem-Sing noun|bit-Acc .
that bit go on there .	det|that-Def-Dem-Sing noun|bit verb|go-Fin-Imp-S adp|on adv|there .
that bit do .	det|that-Def-Dem-Sing noun|bit aux|do-Fin-Ind-Pres-P3 .
that's a bridge .	pron|that-Dem~aux|be-Fin-Ind-Pres-S3 det|a-Ind-Art noun|bridge .
it can go up on the bridge .	pron|it-Prs-Nom-S3 aux|can-Fin-S verb|go-Inf-S adp|up adp|on det|the-Def-Art noun|bridge .
that's go on there .	pron|that-Dem~aux|be-Fin-Ind-Pres-S3 verb|go-Inf-S adp|on adv|there .
that go on there .	pron|that-Dem verb|go-Fin-Ind-Pres-P3 adp|on adv|there .
and tha:t go on there .	cconj|and pron|that-Dem verb|go-Fin-Ind-Pres-P3 adp|on adv|there .
move it along .	verb|move-Fin-Imp-S pron|it-Prs-Acc-S3 adv|along .
I'm finding this bit now .	pron|I-Prs-Nom-S1~aux|be-Fin-Ind-Pres-S1 verb|find-Part-Pres-S det|this-Def-Dem-Sing noun|bit-Acc adv|now .
I'm finding this bit .	pron|I-Prs-Nom-S1~aux|be-Fin-Ind-Pres-S1 verb|find-Part-Pres-S det|this-Def-Dem-Sing noun|bit-Acc .
that's it .	pron|that-Dem~aux|be-Fin-Ind-Pres-S3 pron|it-Prs-Nom-S3 .
no this one there .	intj|no det|this-Def-Dem-Sing noun|one adv|there .
and that go on there .	cconj|and pron|that-Dem verb|go-Fin-Ind-Pres-P3 adp|on adv|there .
you says go up there .	pron|you-Prs-Nom-S2 verb|say-Fin-Ind-Pres-S3 verb|go-Inf-S adp|up adv|there .
it's not .	pron|it-Prs-Nom-S3~aux|be-Fin-Ind-Pres-S3 part|not .
no it can go there .	intj|no pron|it-Prs-Nom-S3 aux|can-Fin-S verb|go-Inf-S adv|there .
yes it go there .	intj|yes pron|it-Prs-Nom-S3 verb|go-Fin-Ind-Pres-S3 adv|there .
this go there .	pron|this-Dem-S1 verb|go-Fin-Imp-S adv|there .
no it don't .	intj|no pron|it-Prs-Nom-S3 aux|do-Fin-Ind-Pres-S3~part|not .
hey , that bit go there .	intj|hey cm|cm det|that-Def-Dem-Sing noun|bit verb|go-Fin-Ind-Pres-S3 adv|there .
go there that bit .	verb|go-Fin-Imp-S adv|there det|that-Def-Dem-Sing noun|bit .
I'm right .	pron|I-Prs-Nom-S1~aux|be-Fin-Ind-Pres-S1 adj|right-S1 .
turn it round .	verb|turn-Fin-Imp-S pron|it-Prs-Acc-S3 adv|round .
turn it round .	verb|turn-Fin-Imp-S pron|it-Prs-Acc-S3 adv|round .
now unplug it .	adv|now verb|unplug-Fin-Imp-S pron|it-Prs-Acc-S3 .
do mine .	aux|do-Fin-Ind-Pres-S3 pron|my-Prs-S1 .
mine instead [?] .	pron|my-Prs-S1 adv|instead .
got it on again .	verb|get-Fin-Ind-Past-S1-irr pron|it-Prs-Acc-S3 adp|on adv|again .
is this one damaged [?] ?	aux|be-Fin-Ind-Pres-S3 det|this-Def-Dem-Sing noun|one verb|damage-Part-Past-S ?
is this one damaged [?] ?	aux|be-Fin-Ind-Pres-S3 det|this-Def-Dem-Sing noun|one verb|damage-Part-Past-S ?
oh it's not on properly that .	intj|oh pron|it-Prs-Nom-S3~aux|be-Fin-Ind-Pres-S3 part|not adp|on adv|properly pron|that-Dem .
I turn it on and on .	pron|I-Prs-Nom-S1 verb|turn-Fin-Ind-Pres-S1 pron|it-Prs-Acc-S3 adp|on cconj|and adv|on .
stop , it's stop .	verb|stop-Fin-Imp-S cm|cm pron|it-Prs-Nom-S3~aux|be-Fin-Ind-Pres-S3 verb|stop-Inf-S .
oh [?] I can find some more .	intj|oh pron|I-Prs-Nom-S1 aux|can-Fin-S verb|find-Inf-S det|some-Def-Ind adj|more-Cmp-S1 .
my , I ca(n't) my train won't work .	pron|my-Prs-Gen-S1 cm|cm pron|I-Prs-Nom-S1 aux|can-Fin-S~part|not pron|my-Prs-Gen-S1 noun|train aux|will-Fin-S~part|not verb|work-Inf-S .
and then that other one .	cconj|and adv|then det|that-Def-Dem-Sing adj|other-S1 noun|one .
that up there .	pron|that-Dem adp|up adv|there .
that's not hard .	pron|that-Dem~aux|be-Fin-Ind-Pres-S3 part|not adj|hard-S1 .
track is broken .	noun|track aux|be-Fin-Ind-Pres-S3 verb|break-Part-Past-S-irr .
no , I can't do a jigsaw .	intj|no cm|cm pron|I-Prs-Nom-S1 aux|can-Fin-S~part|not verb|do-Inf-S det|a-Ind-Art noun|jigsaw-Acc .
hey my train set can go round there .	intj|hey pron|my-Prs-Gen-S1 noun|train noun|set aux|can-Fin-S verb|go-Inf-S adv|round adv|there .
you can make a I can make a fat one for the big one .	pron|you-Prs-Nom-S2 aux|can-Fin-S verb|make-Inf-S det|a-Ind-Art pron|I-Prs-Nom-S1 aux|can-Fin-S verb|make-Inf-S det|a-Ind-Art adj|fat-S1 noun|one-Acc adp|for det|the-Def-Art adj|big-S1 noun|one .
mummie I can make a big one .	noun|mummie pron|I-Prs-Nom-S1 aux|can-Fin-S verb|make-Inf-S det|a-Ind-Art adj|big-S1 noun|one-Acc .
where's my , where's my tunnel ?	adv|where~aux|be-Fin-Ind-Pres-S3 pron|my-Prs-Gen-S1 cm|cm adv|where~aux|be-Fin-Ind-Pres-S3 pron|my-Prs-Gen-S1 noun|tunnel ?
hey where's my tunnel ?	intj|hey adv|where~aux|be-Fin-Ind-Pres-S3 pron|my-Prs-Gen-S1 noun|tunnel ?
now I play my tunnel .	adv|now pron|I-Prs-Nom-S1 verb|play-Fin-Ind-Pres-S1 pron|my-Prs-Gen-S1 noun|tunnel-Acc .
is that a bridge ?	aux|be-Fin-Ind-Pres-S3 sconj|that det|a-Ind-Art noun|bridge ?
this one a tunnel and that's a bridge .	det|this-Def-Dem-Sing noun|one det|a-Ind-Art noun|tunnel cconj|and pron|that-Dem~aux|be-Fin-Ind-Pres-S3 det|a-Ind-Art noun|bridge .
but it's going down my tunnel first .	cconj|but pron|it-Prs-Nom-S3~aux|be-Fin-Ind-Pres-S3 verb|go-Part-Pres-S adp|down pron|my-Prs-Gen-S1 noun|tunnel adv|first .
that's it .	pron|that-Dem~aux|be-Fin-Ind-Pres-S3 pron|it-Prs-Nom-S3 .
yeah , is that yours ?	intj|yeah cm|cm aux|be-Fin-Ind-Pres-S3 sconj|that pron|your-Prs-S2 ?
it's not .	pron|it-Prs-Nom-S3~aux|be-Fin-Ind-Pres-S3 part|not .
it's Adam .	pron|it-Prs-Nom-S3~aux|be-Fin-Ind-Pres-S3 propn|Adam .
right I make a man .	adv|right pron|I-Prs-Nom-S1 verb|make-Fin-Ind-Pres-S1 det|a-Ind-Art noun|man-Acc .
no , I won't [?] .	intj|no cm|cm pron|I-Prs-Nom-S1 aux|will-Fin-S~part|not .
another [?] one here .	det|another-Def-Ind noun|one adv|here .
here [?] a road .	adv|here det|a-Ind-Art noun|road .
you [?] can .	pron|you-Prs-Nom-S2 aux|can-Fin-S .
this is car road like this .	pron|this-Dem-S1 aux|be-Fin-Ind-Pres-S3 noun|car noun|road adp|like pron|this-Dem-S1 .
I'm [?] not .	pron|I-Prs-Nom-S1~aux|be-Fin-Ind-Pres-S1 part|not .
you got one in there .	pron|you-Prs-Nom-S2 verb|get-Fin-Ind-Past-S2-irr num|one adp|in adv|there .
and then play with [?] them .	cconj|and adv|then verb|play-Fin-Imp-S adp|with pron|they-Prs-Acc-P3 .
and put them in there .	cconj|and verb|put-Fin-Imp-S pron|they-Prs-Acc-P3 adp|in adv|there .
xxx instead xxx is xxx xxx men .	adv|instead aux|be-Fin-Ind-Pres-S3 noun|man-Plur .
me instead ?	pron|I-Prs-Acc-S1 adv|instead ?
built it again .	verb|build-Fin-Ind-Past-S1-irr pron|it-Prs-Acc-S3 adv|again .
is that a car road ?	aux|be-Fin-Ind-Pres-S3 sconj|that det|a-Ind-Art noun|car noun|road ?
I'm making chairs .	pron|I-Prs-Nom-S1~aux|be-Fin-Ind-Pres-S1 verb|make-Part-Pres-S noun|chair-Plur-Acc .
that [?] do again .	pron|that-Dem verb|do-Fin-Ind-Pres-P3 adv|again .
